█▀▀▀▀▀▀▀▀▀▀▀▀▀▀▀▀▀▀▀▀▀▀▀▀▀▀▀▀▀▀▀▀▀▀▀▀▀▀▀▀▀▀▀▀▀▀▀▀▀▀▀▀▀▀▀▀▀▀▀▀▀▀▀▀▀▀▀▀▀▀▀▀▀▀▀▀▀▀█
 █                                                                              █
 █                                                                              █
 █______________________________________________________________________________█
 █                                                                              █
 █                                                                              █
 █                                                                              █
 █------------------------------------------------------------------------------█
 █                                                                              █
 █                                                                              █
 █______________________________________________________________________________█
 █                                                                              █
 █                                                                              █
 █                                                                              █
 █______________________________________________________________________________█
 █                                                                              █
 █                                                                              █
 █                                                                              █
 █                                                                              █
 █                                                                              █
 █______________________________________________________________________________█
 █                                                                              █
 █                                                                              █
 █                                                                              █
 █______________________________________________________________________________█
 █                                                                              █
 █                                                                              █
 █                                                                              █
 █                                                                              █
 █                                                                              █
 █______________________________________________________________________________█
 █                                                                              █
 █                                                                              █
 █                                                                              █
 █▄▄▄▄▄▄▄▄▄▄▄▄▄▄▄▄▄▄▄▄▄▄▄▄▄▄▄▄▄▄▄▄▄▄▄▄▄▄▄▄▄▄▄▄▄▄▄▄▄▄▄▄▄▄▄▄▄▄▄▄▄▄▄▄▄▄▄▄▄▄▄▄▄▄▄▄▄▄█ 