████████████████████████████████████████████████████████████████████████████████
 █                                                                              █
 █                                                                              █
 █______________________________________________________________________________█
 █                                                                              █
 █                                                                              █                                    
 █                                                                              █
 █                                                                              █
 █                                                                              █
 █------------------------------------------------------------------------------█
 █                                                                              █
 █                                                                              █
 █                                                                              █
 █______________________________________________________________________________█
 █                                                                              █
 █                                                                              █
 █                                                                              █
 █..............................................................................█
 █                                                                              █
 █                                                                              █
 █                                                                              █
 █______________________________________________________________________________█
 █                                                                              █
 █                                                                              █
 █                                                                              █
 █------------------------------------------------------------------------------█
 █                                                                              █
 █                                                                              █
 █                                                                              █
 █                                                                              █
 █                                                                              █
 █______________________________________________________________________________█
 █                                                                              █
 █                                                                              █
 █                                                                              █
 ████████████████████████████████████████████████████████████████████████████████